111111111111111111111111111111
100000000000000000000000000001
101111111110111111011111111101
101000000000000000000000000101
101111111110011110011111111101
100000000000110011000000000001
101010001010100001010100010101
101011111010000000010111110101
101000000010100001010000000101
101011111010100001010111110101
101010001010111111010100010101
100000000000000000000000000001
101111111110111111011111111101
101000000000000000000000000101
101111111110111111011111111101
100000000000000000000000000001
111111111111111111111111111111

G-13-9-BLUE;G-14-9-RED;G-15-9-YELLOW;G-16-9-GREEN;P-14-15